XXXXXXXXXXXXXXXSSSSSXXXXXXXXXXXXXXXXXXXXXXXXXXXXXXXXXXXXSSSSSSPPFPPPPSPPFPPPFPPPPSSSSSSSSSSSPPFPFPPSSSSSSSXXXXXXXXXXXXXXXXXXXXXX
XXXXXXXXXXXXXXXSSSSSSXXXXXXXXXXXXXXXXXXXXXXXXXXXXXXXXXXSSSSSSPPFFFFPPPPFFFFFFPPPFPPPSSSSSSPPPFFFFFPPPSPPPSXXXXXXXXXXXXXXXXXXXXXX
XXXXXXXXXXXXXXSSSSSSSSXSXXXXXXXXSSXXXXXXXXXXXXXXXXXXXXSSSSSSSPFFFFFPFFFFFFFFFFPFFPPPPSSSSSPPPPFFFFPPPPPPPPSSXSXXXXXXXXXXXXXXXXXX
XXXXXXXXXXXXXXSSSSSSSSSSSXXXXXXSSXXXXXXXXXXXXXXXXXXXXSSSSSSSSPPPPPPPFFFFFFFFFFFFFPPPPSSSSSPPPPFFFFPPPPPPPPSSSSSXXXXXXXXXXXXXXXXX
XXXXXXXXXXXXXSSSSSSSSSSSSSXXXXSSSSXXXXXXXXXXXXXXXXXXSSSSSSSSSPPPPPPPFFFFRFFFFFFFFFPPSSSSSSSPPPFFFFFPPPPPPPSSSSSSSSSSXXXXXXXXXXXX
XXXXXXXXXXXXXSSSSSSSSSSSSSSXXSSSSSSXXXXXXXXXXXXXXXXXSSSSSSSSSPPPPPPPPFFFRFFRRFFFFFFPSSSSSSSSPPFFFFFFPPPPPPSSSSSSSSSSSXXXXXXXXXXX
XXXXXXXXXXXXSSSSSSSSSPPPPPSPSSSSSSSSXXXXXXXXXXXXXXXXSSSSSSSSSPPPSSPPPPFFFFFFRRRFFFFFPSSSSSSSPPFFFRRRFPPPPSSSSPPPPSSSSSSXXXXXXXXX
XXXXXXXXXXXXSSPPSSSSSPPPPPPPSSSSSSSSXXXXXXXXXXXXXSSSSSSSSSSSPPPSSSPPPFFFFFRFFRRRFFFFPPSSSSSPPPFFFRRRFPPPSSSSPPPPPPPSSSSSXXXXXXXX
XXSXXXXXXXXSSSPPPSSSPPPPPPPPPSSSSSSSSXXXXXXXXXSXXSSSSSSSSSSSPPSSSSPPPFFFFFRFRRRRRRFFFPPSSSSSPFFFRRRRFFPPSSPPPPPPPPPSSSSSXXXXXXXX
XSSSSXXXXXXSSSPPPPPPPPPPPPPPSSSSSSSSSXXXXXXXXSSSSSSSSSSSSSSSSPSSSSPPPPPFFRRRRRRRRRFFFPPPSSPPPFFFFFRFFFPPSPPPPPPPPPSSSSSSXXXXXXXX
SSSSSSXXXSSSPPPPPPPFFPPPPPSSSSSSSSSSSXXXXXXXSSSSSSSSSSSSSSSSSSSSSSSPPPPFFRRRRRRRFFFFFPPPPSPPFFFFFFFPPPPPPPPPPPPPPPPSSSSXXXXXXXXX
SSSSSSXXXSSSPPPPPPFFFFPPPPSSSSSSSXSSSXXXXXXXXSSSSSSSSSSSSSSSSSSSSSSSPPPFFFRRRRRFFFFFFPPPPPPFFFFFFFFPPPPPPPPPPPPPPPSSSSXXXXXXXXXX
SSSSSSSSSSSSPPPPPFFFFFPPPPSSSSSSXXXXXXXXXXXXXSSSSSSSSSSSSSSSSSSSSSSSPPPPFFRRRRFFFFFFPPPPPFFFRFFFRRFPPPFFPPPPPPPPPPSSSXXXXXXXXXXX
SSSPSPSSSSSSSPPPFFFFFPPPPPSSSSXXXXXXXXXXXXXXXSSSSSSSSSSSSSSSSSSSSSSSPPPPPFFRRRRFFFFFPPFFFFFFFRRFFRRFFFFFPPPFFPPPPPSSSXXXXXXXXXXX
SPPPPPPPSSSSPPPPPFFFFFPPFFPSSXXXXXXXXXXSSSSSSSSSSSSSPSSSSSSSSSSSSSSPPPPPPPFRRRRFRRFFPPFRRRRRRRRFFFFFFFFFFFFFFFPPPPPSSXXXXXXXXXXX
PFPPFFPPSSSSPPPPPFFRRFFFFFSSSXXXXXXXSSSSSSSSSSSSSSSPPSSSSSSSSSSSSSPPPPPPPPFRRRRRRRRFFFRRRRRRRFFFFFFFFFFFFFRRFFFFFPPPSXXXXXXXXXXX
FFFFFFFPPPSPPPPFFFFRRRFFFPPSSSXXXXXSSSSSSSSSSSSSSSSPPPSSSSSSSSSSSSPPPPPPPPFFRRRRRRRRFRRRRRRRFFFFFFFFRFFFFFFRRRFFRFPPSXXXXSSSXXXX
FFFFFFFFPPPPPPFFFRRRRRFFFPPPSSSXXXXSSSSSSSSSPPSSSSSPPPPSSSSSSSSSSSSPPPPPPPFFFRRRRRRRFFRRRRRFFFFFFFFFRFPPFFFFRRRRRFPPSSXXXSSSXXXX
FFFFFFFFFPFFFFRFRRRRRRFFPPPPPSSSSXXSSSSSSPPPPPPSSPPPPPPSSSSSSSSSSSSPPPPPPFFRRRRRRRRRFRRRRRFFFFFFFFFFFFPPPFFFFFRRFFPPPPSSSSSSSSXX
FFFFFFFFFPFFFRRFFRRRRFFFPPPPSSSSSSSSSSSSSPPPPPPPPPPPPPPPPSSSSSSSSSPPPPPPPFFFRRRRRRRRRRRRRFFFFFFFFFPPPPPPPPFFFFRRFPPPPPSSSSSSSSSX
FFFFFFFFFFRRRRFFFFFRFFFPSPPPSSSSSSSSSSSSPPPPPPPPPPPPPPPPPPSSSSSSSSPPPPPPPFFFRRFFFFFRRRRFFPFFFFFFPPPPPPPSSPPFFFFFFPPPPPPSSSSSSSSX
PFFFFFFFFFRRRRFFFFFFFFFPSSSSSSSSSSSSSSSSSPPPPPPPPPPPPPPPPPPSSSSSSSSPPPPPPPFFFFFFFFFFFRFFPPFFFFFPPPPPPPSSSSPPFFFFPPPPPPSSSSSSSSSX
PFFFFFFFFRRRRFFFFFFFFFPPSSSSSSSSSSSSSSSSSSSPPPPPPPPPSSSPPPPPPSSSSSSPPPPPPPFFRRFFFFFFFFFFPPFFFFPSPSSPPPSSSSSPFPFPPPPPPSSSSSSSSSSX
SPFFFFFFFFRRRFFFFFRFFPPSSSSSSSSSSSSSSSSSSSSSSPSSSPSSSSSPPPPPPSSSSSSSSPPSPFFFRRFFFFFFFFFPPPPPPPSSSSSSSSSSSSSPPPPPSSSSSSSSSSSSSSSX
PFFFFFFRRRFRRFFFRFRRPPPSSSSSSSSSSSSSSSSSSSSSSSSSSSSSSSPPPPPSSSSSSSSSSSSSSPFFRRRRRFFFPPPPPPPPPPSSSSSSSSSSSSPPPPPSSSSSSSSSSSSSSSSX
PFFFFFFFRFFRRFFRRRRRFPPSSSSSSSSSSSSSSSSSSSSSSSSSSSSSPPPPPPPSSSSSSSSSSSSSPPFFFRRRRFFFFPPPPPPPPPSSSSSSSSSSSSPPPPPSSSSSSSSSSSSSSSSX
PFFFFFFFFFFFFFFFRRRRFPPPPPSSSSSSSSSSSSSSSSSSXXXSSSSSPPPPPPPSSSSSSSSSSSSSPPFFFRRRRFFFFPPPFFFPPPPPSPSSSSSSPPPPPPPSSSPPSSSSSSSSSSSX
PFFFFFRRFRRRFFFRRRRFPPPPPPPSSSSSSSSSSSSSSSSSXXXXSSSSPPPPPPPSSSSSSSSSSSSPPPFFFFFFRFFFFFFFRFFPPPPPPPPSSSSPPPPPPPPSSSPPPPSSSSSSSSSX
PFRRRRRRRRRRFFRRRRRPPPPPPPPPSSSSSSSSSSSSSSSSXXXXXSSSSPPPPPPSSSSSSSSSSSPPPPFFFFFFFFPPFFFRFFPPPPPPPPPSPPPPPPPPPPPPSSPPPPPSSSSSSXXX
PRRRRRRRRRRRRRRFRRRFPPPPPPPPPPPSSSSSSSSSSSSSXXXXXXXSSPPPPPPSSSSSSSSSSSPPPPPFFFFFFFFFFFFRFFPPPPPPPPPPPPPPPPPPPPPPPPPPPPPPPSSSXXXX
FFRRRRRRRRRRRFRRRRRFFPPPPPPPPPPSSSSSSSSSSSSSSXXXXXXXSSPPPSSSSSSSSSSSSSPPPPPPPPPFFFFFFFRRRFPPPPPPPPPPPPPPPPPPPPFFFFPPPPPPPSSSXXXX
FFFRRRRRRRRRRFFRRRRRFFPPPPPPPPSSSSSSSSSSSSSSSXXXXXXXSSSPSSSSSSSSSSSSSPPFFPPPPPPPPFFFFFFRRFPPPPPPPPPPPPPPPPPPPPFFRFFPPPPPPSSSXXXX
FFFRRRRRRRRRFFFFRRRRFFPPPPPPPPSSSSSSSSSSSSSSSSXXXXXXSSSSSSSSSSPPPSSSSPPFFFFFFPPPPPFFFFFRFPPPPPPPPPPPFFFFPPPPPFFFRRFPPPPPPSSSSXXX
FFFRRRRRRRRFFFFFRRRRRFPPPPPPPSSSSSXXSSSSSSSSSSSXXXXSSSSSSSSSSSPPPSSSSSSPFFFFFFPPPPPFFFFPPPPPPPPPPPPPFFFFPPPPPFFFRFFPPPPPPSSSXXXX
FRRRRRRRRFFFPFFFFFRFFFPPPPPPPSSSSXXXXSSSSSSSSSSSSSSSSSSPPSSSSSPSSSSSSSSPFFFFFPPPPPPPPPPPPPSPPPPPPPPPFFFFFFPPPFFFRRFPPPPPPSSSSXXX
FRRRRRRRRFPPPFFFFFFFFFPPPPSSSSSSSXXXSSSSSSSSSSSSPPPPSPPPPSSSSSSSSSSSSSSPPFFFPPPPPPPPSSPPSSSSPPPPPPPPPPPFFFPFFFFRRRFFPPPPPSSSSXXX
FRFRRRRRFFPPPPPPPPPPFPPPPPSSSSSXXXXXSSSSSSSSSSSPPPPPPPPPPSSSSSSSSSSSSSSSPPPPPPPPPPSSSSSSSSSSSSPPPSSPPPPPFFFFFFFRRFPPPPPPSSSSXXXX
FFRRRRFFFFPPPPPPPPPPPPPPPPSSSSSXXXXXXXSSSSSSSSPPPPPPFFFFPPPSSSSSSSSSSSSSSPPSSSPPSSSSSSSSSSSSSSSSSSSSPPPPFFFFFFFFFPPPPPSSSSSSXXXX
FFRRRFFFFFPPPPPPPPPPPPPPPSSSSXXXXXXXXXXXSSSSSPPPPPPPFFFFFPSSSSSSXXXSSSSSSSSSSSSSSSSSSSSSSSSSSSSSSSSSSPPPFFFFFFFPPPPSSSSSSSSSXXXX
PFRRFFFFFPPPPPPPPPPPSSPPPSSSXXXXXXXXXXXXSSSSPPPPPPPPFFFFFPPSSSSSXXXXXXXXSSSSSSSXXXXXSSSSSSSSSSSSSSSSSPPPFFFFFFPPPPSSSSSSSSSSSSXX
FFFFFFFFFPPPPPPPPPPPSSPPPSSSXXXXXXXXXXXSSSSPPPFFFFPPFFPPFPPSSSSSXXXXXXXXXXXXXXXXXXXXXXXXXSSSSSSSSSSSSPPPFFFFFPPPPPSSSSSSXSSSSSSX
PFFFFFFFFPPPPPPPPPSSSSPPPSSSXXXXXXXXXXSSSSSPPFFFFFFFFPPPPPPPPPPSXXXXXXXXXXXXXXXXXXXXXXXXSSSSSSSSSSSSSPPPPPPFFPPPSSSSSSSXXSSSSSSX
PFFFFFPPFFPPPPPPPPPSSPPPPPSXXXXXXXXXSSSSSSSPFFFFFFFFFPPPPPPPPPPSSXXXXXXXXXXXXXXXXXXXXXXSSSSSSSSSSSSSSSPPPPPPPPPSSSSSSSXXSSSSSSSS
FFFFFFPPFFPPPPPPPPPPPPPPPPSXXXXXXXXXXSSSSSPPFFFFFFFPPPPPFFPPPPPPSSXXXXXXXXXXXXXXXXXXXXXSSSSSSSSSSSSSSSPPPPPPPPPSSSSSSSXXXSSSSSSS
FFFFFFFPPPPPPPPPPPPPPPPPPSSXXXXXXXXXXSSSSSPFFFFPPFFPPPPFFFPFFPPPSSSXXXXXXXXXXXXXXXXXXXXXSSSSSSSSSSSSSSSSSPPPPPPPSSSSSXXXXXXSSSSS
PPFFFFPPSSSPPPPPPPPPPPPPPSSXXXXXXXXXXSSSSPPFFFFPPFFPPPPFFFFFFPPPSSSSXXXXXXXXXXXXXXXXXXXXXSSSSSSSSSSSSSSSSSPPPPPPPPSSSXXXXXSSSSSS
PFFFFPPPSSSSPPPPPPPPPPPPPPSXXXXXXXXXXSSSSPPPFFFPPFFPPPPPFFFPPPPPPSSSXXXXXXXXXXXXXXXXXXXXXXXSSSSSSSSSSSSSSSPPPPPPPPPPSXXXXXXSSSSS
PFFFPPPSSSSSSPPPPPPPPPPPPPSSSXXXXXXXXPPPPPPPFFFPPFFPPPPPPFFPPPPPPPPSSXXXXXXXXXXXXXXXXXXXXXXXSSSSXSSSSSSSSPFFFFPPFPPPSSSXXXXSSSPP
FFFPPPPSSSSSSPPFFPPPPPPPPPSSSXXXXXXXSSPPPPPFFFPPPPPPPPPPPPPPPPPPPPPSSXXXXXXXXXXXXXXXXXXXXXXXXXXXXXSSSSSPPPFFFFFFFPPPPPSXSSSSSSPP
PPPPPPSSPSSSSSPPPPPPPPPPPPSSSSXXXXXSSSPPFFFFFFFPPPPPPPPPPPPPPPPSSPSSSSXXXXXXXXXXXXXXXXXXXXXXXXXXXXSSSSPPPFFFFFFFPPPPPPSSSSSSSPPP
PPPSSSPPPSSSSPPPFPPPFPPPPSSSSXXXXXXSSSPFFFFFFFPPPPPPPPPPPPPPPPSSSSSSSSXXXXXXXXXXXXXXXXXXXXXXXXXXXXXSSSPPPPFFFFFFPPPPPPSSSSSSSSPP
SPSSSSPPPSSSPPPPFFPFFFPPPPSSXXXXXXXSSSPFFFFFFFFFPPPPPPPPPPPPSSSSXXSSXXXXXXXXXXXXXXXXXXXXXXXXXXXXXXXXXSSPPPFFFFFPPPPPPPSSSSSSSSPP
SSSSSSPPPSSSSPPPFFPFFPPPPSSSXXXXXXXSSSPPFFFFFFFFPPPPPPPPPPPSSSSXXXXXXXXXXXXXXXXXXXXXXXXXXXXXXXXXXXXXXSSSPPFFPFPSSPPPPPSSSSSSSSPS
SSSSSSSPPSSSSSSPPPPPPPPPSSSSSXXXXXXXSPPPFFPPFPPPPPPPSSPPPPPSSSSXXXXXXXXXXXXXXXXXXXXXXXXXXXXXXXXXXXXXXSSSSPPPPPSSPPPPPSSSSSSSSSSS
SSSSSSPPPSSSSSSSPPPPPPPPSSSSSSXXXXXXSPPPPPPPPPPPPPPSSSSPPSSSSXXXXXXXXXXXXXXXXXXXXXXXXXXXXXXXXXXXXXXXXXSSSSPSSSSSPPPPPSSSSSSSSSSS
XXXSSSPPSSSSSSSSPPPPPPPPSSSSSSXXXXXXXSPPPPPPSSSSSSSSSSSSSSSSXXXXXXXXXXXXXXXXXXXXXXXXXXXXXXXXXXXXXXXXXXSSSSSSSSSSPPPPPPSSSSSSSSXX
XXXSSSPPSSSSSSSSSPPPPPPPSSSSSSSXXXXXXSSSPPSSSSSSSSSSSSSSSSXXXXXXXXXXXXXXXXXXXXXXXXXXXXXXXXXXXXXXXXXXXXXXXSSSSSSPPPPPPPSPPSSSSSXX
XXXSSPPPPSSSSSSSSSPFPPPPPSSSSSSSXXXXSSSSSSSSSSSSSSSSSSSSSSSXXXXXXXXXXXXXXXXXXXXXXXXXXXXXXXXXXXXXXXXXXXXXXXSSSSSSSPPPPPPPPPPSSSXX
XXXXSPPPPSSSSSSSSPPFFPPPPPPPSSSSSXXXSSSSSSSSSSSSSSSSSSSSSSSXXXXXXXXXXXXXXXXXXXXXXXSXXXXXXXXXXXXXXXXXXSXXXXSSSSSSSSSSPPPPPPPPSSXX
XXXSSSSPPSSSPSSPPPPFFFPPPPPPSSSSSSSSSSSSSSSSSSSSSSSSSSSSXXXXXXXXXXXXXXXXXXXXXXXXXXSSSXXSSXXSSSSXXXSSSSSXXXSSSSSSSSSSSSPPPPPPSSXX
XXXSSSSSPSSPPPPFFFFFFFPPFFPPSSSSSSSSSSSSSSSSSXXSSSSSSSSSXXXXXXXXXXXXXXXXXXXXXXXXSSSSSSSSSSSSSSSSXSSSSSSSSXSSSSSSSSSSSSSPPPPSSSSX
XXXXSSSSSSSPPPPFFFFFFFFFFFFPPSSSSSSSSSSSSSSSSXXSSSSSSSSSXXXXXXXXXXXXXXXXXXXXXXXXXSSSSSSSPPSSSSSSSSSSSSSSSSSSSSSSSSSSSSSSSSSSSSSS
XXXXXSSSSSSPPPPFRFFFRFFFFFFPPSSSSSSSSSSSSSSSSXXSSSSSSSSSSXXXXXXXXXXXXXXXXXXXXXXXXSSSSSSSPPPPPSSSSSSSSSSSSSSSXXXSSSSSSSSSSSSSSSSX
XXXXXSSSSSSSPPPFRRRRRRRRFFFFPPSSSSSSSSSSSSSSSXXXXSSSSSSSSSSXXXXXXXXXXXXXXXXXXXXXXSSSSSSSPPPPPPSSSSSSSSSSXXXXXXXXSSSXXSSSSSSSSSSX
SSXSSSSSSSSSSPFRRRRRRRRRFFFPPPSSSSSSSSSSSSSSXXXXSSSSSSSSSSSSXXXXXXXXXXXXXXXXXXXXXXSSSSSPPPPPPPSSSSSSSSSSXXXXXXXXXSXXXSSSSSSSSSSX
SSSSSSSSSSSPPFFRRRRRRRRRFFFPPPSSSSSSSSSSSSXXXXSSSSSSSSSSSSSSSXXXXXXXXXXXXXXXXXXXXXSSSSSPPPPPPPPSSSSSSSSSXXXXXXXXXSSSSSSSSSSSSSSX
SSSSSSSSSSSPPFFRRRRRRRRRFFFPPPPSSXXSSSSSSSXXSSSSSSSSSSSSSSSSSXXXXXXXXXXXXXXXXXXXXXXXSSPPPPPPPPPSSSSSSSSSXXXXXXXXSSSSSSSSSSSSSSSX
SSSSPPPSSSPPFFRRRRRRRRRRRFPPPPSSSXXXXXSSSSSSSSSSSSSSSSSSSSSSXXXXXXXXXXXXXXXXXXXXXXXXSSPPPPPPPPPPSSSSSSSXXXXXXXSSSPPPPSSSSSSSSSSS
PSSSPPPSSPPFFRRRRRRRRRRRRFPPSSSXSXXXXXXXSSSSSSSSSSSSSSSSSSXXXXXXXXXXXXXXXXXXXXXXXXXXSSSSSSPPPPPPPSSSSSSXXXXXXSSSPPPPPSSSSSSSSSSS
SPPPPPPPPPFFFRRRRFRRRRRRRFPPSSXXXXXXXXXXSSSSSSSSSSSSSSSSSSXXXXXXXXXXXXXXXXXXXXXXXXXXXSSSSSSPPSSPPSSSSSSXXXXXXSSPPPPPPPSSSSSSSSSS
SPPPPPFFFFFRRRRRRRRRRRRRRPPPSSXXXXXXXXXXXXXSSSSSSSSSSSSSSSXXXXXXXXXXXXXXXXXXSXXXXXXXXSSSSSSSSSSSSSSSSXXXXXXSSPPPPPFFPPPSSSSSSSSS
SPPPPFFFFRRRRFFRRRRRRRRRRFPSSSSXXXXXXXXXXXXSSSSSSSSSSSSSSSXXXXXXXXXXXXXXXXXXSXXXXXXXXSSSSSSSSSSSSSSSSXXXXXXSSPPPPFFFFPPPSSSSSSSS
PPPPPFFFFFRFFFFRRFRRRFFRFFPSSSSXXXXXXXXXXXXXSSSSSSSSSSSSSXXXXXXXXXXXXXXXXXXSSXXXXXXXXSSSSSSXXXSSSSXXXXXXSSSSSPPFFFFFFFPPPPSSSSSS
SPPPPPPFFFFFFFFRRFRRRFFFFFSSSSSSXSXXXXXXXXXXSSSSSSSSSSSSSXXXXXXXXXXXXXXXXXSSSSXXXXXXXSSSSSSSXXXSSXXXXXXXXSSSSSSPFFFFFFPPPPSSSSSS
PPPPPPPFFFFFFFFRRFFFRRFFFPSSSSSSSSSXXXXXXXXXSSSSSSSSSSSSSXXXXXXXXXXXXXXXXXSSSXXXXXXXXXSSSSSSXXXXSXXXXXXXXSSSSSSSPPPPFFPPPPSSSSSX
SPPPPPPFFFFFFFFRFFFFFFFFPPPSSSSSSSXXXXXXXXSSSSSSSSSSSSSSXXXXXXXXXXXXXXXXXXXXXXXXXXXXXXSSSSSSXXXXXXXXXXXXXXSSSSSSSPPPPPPPPPSSSSSX
PPPPPPFFFRFFFFFFFFFFFFFPPPPSSSSSSSSXXXXXXSSSSSSSSSSSSSSXXXXXXXXXXXXXXXXXXXXXXXXXXXXXXXXSSSSXXXXXXXXXXXXXXXSSSSSSSSSSPPPPPSSSSSSX
SPPPFFFFRRRRFFFFFFFFFFPPPPPSSSSSSSXXXXXXSSSSSSSSSSSSSSSXXXXXXXXXXXXXXXXXXXXXXXXXXXXXXXXXXXXXXXXXXXXXXXXXXXSSSSSSSSSSPPPPPSSXXXXX
PPFFFFFFRRRRRRRFFFFFFPPPSSSSSSSSSSXXXXXSSSSSSSSSSSXXSXXXXXXXXXXXXXXXXXXXXXXXXXXXXXXXXXXXXXXXXXXXXXXXXXXXXSSSSPPPPSSSSSSSSXXXXXXX
PFFFFFFRRRRRRRRFFFFFFFPSSSXXSSSSXXXXXXSSSSSSSSSSSSXXXXXXXXXXXXXXXXXXXXXXXXXXXXXXXXXXXXXXXXXXXXXXXXXXXXXXSSSSSPPPPSSSSSSSSXXXXXXX
FFFFFFFFRRRRRFFFFFFFFFPSXXXXXSSXXXXXXXSSSSSSSSSSSSXXXXXXXXXXXXXXXXXXXXXXXXXXXXXXXXXXXXXXXXXXXXXXXXXXXXSSSSSSPPPPPPSSSSSSXXXXXXXX
PPFFFFFRRRRRRFFFFFFFFFPSSXXXXXXXXXXXXXXXXSSSSSSSSXXXXXXXXXXXXXXXXXXXXXXXXXXXXXXXXXXXXXXXXXXXXXXXXXXXXXSSSSSSPPPPPPSSSSSSXXXXXXXX
PPPPPPFRRRRRRFFFFFFFFFPPSXXXXXXXXXXXXXXXXSSSSSSSXXXXXXXXXXXXXXXXXXXXXXXXXXXXXXXXXXXXXXXXXXXXXXXXXXXXXXSSSSSPPPPPPPSSSSSSXXXXXXXX
SPFPPPFFFRRRFFFFFFFFFFPSSXXXXXXXXXXXXXXXXXSXSSXXXXXXXXXXXXXXXXXXXXXXXXXXXXXXXXXXXXXXXXXXXXXXXXXXXXXXXSSSSSSPPPPPPSSSSSSSSSXXXXXX
FFFFPPFFFFFFFFFFFFFFFPPSSXXXXXXXXXXXSXXXXXXXXXXXXXXXXXXXXXXXXXXXXXXXXXXXXXXXXXXXXXXXXXXXXXXXXXXXXXXXSSSSSSPPPPPPPPSSSSSSSSSXXXXX
PFFFPPPFFFPPFFFFFRFFFPPSSXXXXXXXXXSSSSSXSSXXXXXXXXXXXXXXXXXXXXXXXXXXXXXXXXXXXXXXXXXXXXXXXXXXXXXXXXXSSSSSSSPPPPPPPPPPSSSSSSSXXXXX
PPFPPPPFFFPFFFFFFRRFFPPSSXXXXXXXXXSSSSSSSSSSSXXXXXXXXXXXXXXXXXXXXXXXXXXXXXXXXXXXXXXXXXXXXXXXXXXXXXXXSSSSSSSPPPPPPPPPPSSSSSXXXXXX
PPPPPPPPPPPFFFFFFFFFPPSSXXXXXXXXXXSSSSSSSSSSSSXXXXXXXSXXXXXXXXXXXXXXXXXXXXXXXXXXXXXXXXXXXXXXXXXXXXXXXXSSSSSPPPPPPPPPSSSSSSXXXXXX
PPPPPPPPPPPPFFFFRFFFPSSSXXXXXXXXXXSSSSSSSSSSSXXXXXXXSSSXXXXXXXXXXXXXXXXXXXXXXXXXXXXXXXXXXXXXXXXXXXXXXXXSSSSSPPPPPPSSSSSSSSSSXXXX
SPPPPPPPPPPPPFFFRFFFPSSSSXXXXXXXXXSSSSSSSSSSSXXXXXSSSSSSXXXXXXXXXXXXXXXXXXXXXXXXXXXXXXXXXXXXXXXXXXXXXXXXSSSSPPPPPSSSSSSSSSSSSSSS
SPPPFPPPPPPPPPFFFFFFPSSSSSXXXXXXXXXSSSSSSSSSXXXXXSSSSSSSSXXXXXXXXXXXXXXXXXXXXXXXXXXXXXXXXXXXXXXXXXXXXXXXSSSSSSPPSSSSSSSSSSSSSSSS
SPPFFPPPPPPPFFFFFFPPPPSSSSSXXXXXXXXXXSSSSSSXXXSSSSSSSSSSSSSXXXXXXXXXXXXXXXXXXXXXXXXXXXXXXXXXXXXXXXXXXXXXSSSSSSSSSSSSXXXXXSSSSSSS
SPPPPPPPPPFFFFFFPPPPPPSSSSSSSSXXXXXXXSSSSSSSSSSSSSSSSSSSSSSXXXXXXXXXXXXXXXXXXXXXXXXXXXXXXXXXXXXXXXXXXXXXXSSSSSSSSSXXXXXXXSSSSSSS
XSPPPPFPPPFFFFFFPPPPPPPPPPSSSSXXXXXXXSSSSSSSSSSSSSSSSSSSSSSSXXXXXXXXXXXXXXXXXXXXXXXXXXXXXXXXXXXXXXXXXXXXXXXXSSSSXXXXXXXXXXXSXXSS
XSSPPPFFPPFFFFFFPPPPPPPPPPPSSSXXXXXXSSSSSSSSSSSSSSSSSSXXXSSXXXXXXXXXXXXXXXXXXXXXXXXXXXXXXXXXXXXXXXXXXXXXXXXXXXXXXXXXXXXXXXXXXXXX
SSPPPPFFPFRRRFPPPPPPPPPPPPPSSSXXXXXXSSSSSSSSSSSSSSSSSSXXXXXXXXXXXXXXXXXXXXXXXXXXXXXXXXXXXXXXXXXXXXXXXXXXXXXXXXXXXXXXXXXXXXXXXXXX
SSPPPPFFFRRRFFFFFFFFFFFFFFPPSSXXXXXXSSSSSSSSSSSSSSSSSSXXXXXXXXXXXXXXXXXXXXXXXXXXXXXXXXXXXXXXXXXXXXXXXXXXXXXXXXXXXXXXXXXXXXXXXXXX
SSPPPFFFFRRFFFRRFFFFFFFFFFPPSSSXXXXSSSSSXXSXSXSSSSSSSSSSSXXXXXXXXXXXXXXXXXXXXXXXXXXXXXXXXXXXXXXXXXXXXXXXXXXXXXXXXXXXXXXXXXXXXXXX
SPPPPFFFFRRRRRRRRRRRFFFRFFPPSSSSSSSSSSSSXXXXXXXSSSSSSSSSSSSXXXXXXXXXXXXXXXXXXXXXXXXXXXXXXXXXXXXXXXXXXXXXXXXXXXXXXXXXXXXXXXXXXXXX
SPPPPFFFFRRRRRRRRRRRFFRRRFPPSSSSSSSSSSSSXXXXXXXXSSSSSSSSSSSXXXXXXXXXXXXXXXXXXXXXXXXXXXXXXXXXXXXXXXXXXXXXXXXXXXXXXXXXXXXXXXXXXXXX
SPPPFFFRRRRRRFFRRRRRFFRRRFPPSSPPPPPSSSSSXXXXXXXXXXSSPSSSSSXXXXXXXXXXXXXXXXXXXXXXXXXXXXXXXXXXXXXXXXXXXXXXXXXXXXXXXXXXXXXXXXXXXXXX
SPPPPFFRRRRRRRRRFFFRFFFRRFFPPPPPPPPSSSSSXXXXXXXXXXXSSPPPPSXXXXXXXXXXXXXXXXXXXXXXXXXXXXXXXXXXXXXXXXXXXXXXXXXXXXXXXXXXXXXXXXXXXXXX
SPPPPFFRRRRRFRRFFFFFFFFFRFFFFFFFPPPPSSSSXXXSSSSSXXXSSPPPPSXXXXXXXXXXXXXXXXXXXXXXXXXXXXXXXXXXXXXXXXXXXXXXXXXXXXXXXXXXXXXXXXXXXXXX
SSPPPFFRRRRRFFRFFFPPPPPFFFFFFFFFPPPPSSSSSSSSSSSSXXXXSPPPPSXXXXXXXXXXXXXXXXXXXXXXXXXXXXXXXXXXXXXXXXXXXXXXXXXXXXXXXXXXXXXXXXXXXXXX
SSPPPFFFFFRRRRFFFFPPPPPFFFFFFFFFFPPPSSPSSSSSSSSSXXXSSPPPPSXXXXXXXXXXXXXXXXXXXXXXXXXXXXXXXXXXXXXXXXXXXXXXXXXXXXXXXXXXXXXXXXXXXXXX
SSPPPPFFFFRRRRRFFFPPPPPPPFFFFFFFPPPPPPPPPSSSSSSSXXXSSSSSSSSSSSSSXXXXXXXXXXXXXXXXXXXXXXXXXXXXXXXXXXXXXXXXXXXXXXXXXXXXXXXXXXXXXXXX
SSSPPPPPFFFRRRFRRFFPPPPPPFFFFFFPPPPPPPPPPSSSSSSSXXSSSSSSSSSSSSSSSSXXXXXXXXXXXXXXXXXXXXXXXXXXXXXXXXXXXXXXXXXXXXXXXXXXXXXXXXXXXXXX
SSPPPPPPFFFFFFRRRRFFFPPPPPPFPPPPPPPPPPPPSSSSSSSSXXSSSSSSSSSSSSSSSSXXXXXXXXXXXXXXXXXXXXXXXXXXXXXXXXXXXXXXXXXXXXXXXXXXXXXXXXXXXXXX
SPPPPPPFFFFFRRRRRRFFFFPPPPPPPPPPPPPPPPPPSSSSSSSSSSSSSSSSSSSSSSSSSSSSSXXXXXXXXXSSSSSSXXXXXXXXXXXXXXXXXXXXXXXXXXXXXXXXXXXXXXXXXXXX
SPPPPPPFFFFFFFFFFRRFFFPPPPPPPPPPPPPPPPPPSSSSSSSSSSSSSSSSSSSSSSSSSSSSSSXXXXXXXSSSSSSSXXXXXXXXXXXXXXXXXXXXXXXXXXXXXXXXXXXXXXXXXXXX
PPPPPPFFFRFFFFFFRRRFFPPPPPPPPPPPPPPPPPPPPSSSSSSSSSSSSSSSSSSSSSSSSSSSSSXXXXXXSSSSSSSSSXXXXXXXXXXXXXXXXXXXXXXXXXXXXXXXXXXXXXXXXXXX
PPFFFFFFRFFFFFFFFRFFPPPPPPPPPPFFFFPPPPPPPSSSSSSSSSPSSSSSSSPPPSSSSSSSSSSXXXXXSSSSSSSSSSSXXXXXXXXXXXXXXXXXXXXXXXXXXXXXXXXXXXXXXXXX
FFFFFFFRRFFFFFPFFFFPPPPPPPPPPPFFRFFFPPPPPSSSSSPPSPPPPPPPPPPPPPSSSSSSSSSXSXXSSSSSSSSSSSSSXXXXXXXXXXXXXXXXXXXXXXXXXXXXXXXXXXXXXXXX
FFFFFFFRRRFFFPPFFFPPPPPPPPPPPPFFRFFFFPPPPPSSSPPPPPPPPPPPPPPPPPSSSSSSSSSSSSSSSSSSSSSSSSSSSSSSSSSSSXXXXXXXXXXXXXXXXXXXXXXXXXXXXXXX
PFFFFFFRRRFFFPPFFFFPPPPPPPPPPPPFRFFFFFFFFPPPPPPPPPPPPPPPPPPPPPSSSSSSSSSSSSSSSSSSSSSSSSSSSSSSSSSSSXXXXXXXXXXXXXXXXXXXXXXXXXXXXXXX
SPPPFPFFRFFFFPPFFFPPPFFPPPPPPFFFRRRRFFFFFFPPFFPPPPPPPFPPPPPPPPSSSSSSSSSSSSSSSSSSSSSSSSSSSSSSSSSSSXXXXXXXXXXXXXXXXXXXXXXXXXXXXXXX
SPPPPPPFFFFFPPPFFFPPFFFFPPFPPFFFRFRRRRRRFFPFFFFPPPPPPFFFPPPPPPSSSSSSSSSSSSSSSSSSSSSSPSSSSSSSSPPPSSXXXXXXXXXXXXXXXXXXXXXXXXXXXXXX
SSPPPPFFFFFFFPPPFFFFFFFFFFFFFFFFFFRRRRRRFFFFFFFFFFFPPPPPPPPPPPSSSSSSSSSSSSSSSSSSSSSSPSSSSSSSPPPPPSSSSXXSSSSSSSSSXXXXXXXXXXXXXXXX
XSSSPPFRRRFFFPPPPPFFFFFFFFFFFFFFFFRRRRFFFFFFRRRRFFFPPPPPPPPPPSSSSSSSSSSSSSSSSSSSSSSSPSSSSSSPPPPPPPSSSSSSSSSSSSSSSSXXXXXXXXXXXXXX
XSSSSPFRRRRFFPPPPPFFFRFFRFFFFFFPFFFFFFFFFFFRRRRRRFFFFPPPPPPPSSSSSSSSSSSSSSSSSSSSSSSSSSSSSSSPPPPPPPPSSSSSSSSSSSSSSSSXXXXXXXXXXXSS
XSSSSPPRRRRFFPPPPPPFRRRRFFFFRFPPFFFFFFFFFFFRRRFRRFFFFPPPPPPSSSSSSSSSSSSSSSSSSSSSSSSSSSSSPPPPPPPPPPPPPSSSSSSSSSSSSSSXXXXXXXXXXSSS
XXSSSSPFRRRRFFPPPPPFRRRFFFFFRFFFFFFPPPPFFFFRRRFFFFFFFFPPPPPSSSSSSSSSSSSSSSSSSSSSSSSSSSSSPPPPPPPPPPPPSSSSSSSSSSSSSSSXXXXXXXXXXSSS
XXXSSSPFRRRRRFFFFFFFRRFFFRRFFFFFFFPPPPPPPPFFFFFFPPFFFFFPPPPSSSSSSSSSSSSSSSSSSSSSSXXXSSSSSPPPPPPPPPPSSSSSSSSSSSSSSSSXXXXXXXXXXSSS
XXXSSSPFFRRRRRFFFFFFFFFFPFRFFFFFFFPPPPPPPPPPFFFPPPPFFFPPPPPPSSSSSSSSSSSSSSSSXXXXXXXXSSSSSPPPPPPPPPPSSSSSSSSSSSSSSSSXXXXXXXXXXXSS
XXXSSSPFFRRRRRFFFFFFRFFPPFFFFPPFFFPPSSSSSSPPPPPPPPPPFPPPPPPPSSSSSSSSSSSSSSSXXXXXXXXXXSSSSSPPPPPPPPSSSSSSPPPSSSSSSSXXXXXXXXXXXXXX
XXXSSSPPFFFFFFFFFFFFFFPPPFFFPPPFFPPPSSXXSSPPPPPPPPPPFFPPPPPPSSSXXXXSSSSSSSSSXXXXXXXXXXXSSSSSSSSSSSSSSSSSPPPSSSXXXXXXXXXXXXXXXXXX
XXSSSPPFFFFFFFFFFFFFFPPPPFFPPPFFFPPSSXXXXXSPPPPPPPPPFPPPPPPPSSXXXXXXSSSSSSSSXXXXXXXXXXSSSSSSSSSSSSSSSSSPPPSSXXXXXXXXXXXXXXXXXXXX
XXSSPPPFFFFFPPPFFFFPPPPPPPPPPPPFFPPSSXXXXXSSSSSPPPPPPPPPPPPSSXXXXXXXXSSSSSSXXXXXXXXXXXXSSSSSSSSSSSSSSSSPPSSXXXXXXXXXXXXXXXXXXXXX
